######
#....#
#.A#.#
#....#
######
[Textures]
---
---
---


