###################.
#.................#.
#.................#.
#.................#.
#.................#.
#.................#.
#.................#.
#.......A.........#.
#.................#.
###################.
