#####
#...#
#.A.#
#...#
#...#
#...#
#...#
#...#
#...#
#####
