###################################################
#.................................................#
#.................................................#
#.................................................#
#.................................................#
#.................................................#
#.................................................#
#.................................................#
#.................................................#
#.................................................#
#.................................................#
#.................................................#
#.................................................#
#.................................................#
#.................................................#
#.................................................#
#.................................................#
#.................................................#
#.................................................#
#.................................................#
#.................................................#
#.................................................#
#.................................................#
#.................................................#
#.................................................#
#.................................................#
#.................................................#
#.................................................#
#.................................................#
#.................................................#
#.................................................#
#.................................................#
#...............#.................................#
#.................................................#
#.................................................#
#.................................................#
#.................................................#
#.................................................#
#.................................................#
#.................................................#
#.................................................#
#.................................................#
#.................................................#
#.................................................#
#.................................................#
#.................................................#
#.................................................#
#.................................................#
#.................................................#
#.................................................#
#.................................................#
#.................................................#
#.................................................#
#.................................................#
#.................................................#
#.................................................#
#.................................................#
#.................................................#
#.................................................#
#.................................................#
#.................................................#
#.................................................#
#.................................................#
#.................................................#
#.................................................#
#.................................................#
########..........................................#
#......#..........................................#
#..#.#.#.................................###......#
#..#.#.#......###..................###...#........#
######.########.####################.#####.########
#.................................................#
##########.....##########..###############.########
#.......................#.#.......................#
#.......................#A#.......................#
###################################################
