#######
#.....#
#.....#
#..A..#
#.....#
#.....#
#######
[Textures]
---
---
---
