###################
#.................#
#.................#
#.................#
#.................#
#.................#
#.................#
#.......A.........#
#.................#
###################
[Textures]
---
---
---
