###################.
#.................#.
#.................#.
#.................#.
#.................#.
#.................#.
#.................#.
#.......A.........#.
#.................#.
###################.
[Textures]
---
---
---
