###############################
#.............................#
#.............................#
#.............................#
#.............................#
#.............................#
#.............................#
#.......A.....................#
#.............................#
###############################
[Textures]
---
---
---
