..........
..........
..........
..........
..........
...A......
.#...#....
.#...#....
.#####....
[Textures]
---
---
