###############################
#.................#...........#
#...#.........................#
#...#.............#...........#
#...#..#..######.##...........#
#...#.............#...........#
#...#.........................#
#.......A.....................#
#.............................#
###############################
[Textures]
---
---
---
